Ablavsky – ablavsky@law.stanford.edu
E. Tendayi Achiume – achiume@law.stanford.edu
Rhiannon Acoba – rhiannon@law.stanford.edu
Candice Adams – cladams@law.stanford.edu
Elaine Adolfo – eadolfo@law.stanford.edu
Rochael Adranly – rochaels@stanford.edu
Mohamed Afane – afane@law.stanford.edu
Nóra Al Haider – ahnora@stanford.edu
Janet Cooper Alexander – jca@stanford.edu
Brenda Alfaro Campos – blalfaro@law.stanford.edu
Easha Anand – eanand@stanford.edu
Michelle Wilde Anderson – manderson@law.stanford.edu
Subini Annamma – subini@stanford.edu
Angela Antia – antia@law.stanford.edu
Amy Applebaum – amya@stanford.edu
Alyssa Ashdown – alyssa.ashdown@law.stanford.edu
Stephanie Ashe – sashe@law.stanford.edu
Noah Asing – kasing@stanford.edu
Meghan Atallah – atallah@stanford.edu
Isabella Aversi Salandini – iaversi@law.stanford.edu
Jason Bade – jwbade@stanford.edu
Eric A. Baldwin – ericbaldwin@stanford.edu
Ian Ballon – Ballon@GTLaw.com
Brendan Ballou-Kelley – ballou@stanford.edu
Ralph Richard Banks – rbanks@stanford.edu
Paul Barker – barker19@stanford.edu
Jorge Barrera Rojas – jbarrer2@stanford.edu
Sylvia Barron – sbarron@law.stanford.edu
Jean-Francois Barthe – jfbarthe@law.stanford.edu
Robert Bartlett – rbartlett@stanford.edu
Zeenat Basrai – zbasrai@law.stanford.edu
Stephanie A. Basso – sbasso@law.stanford.edu
Marilyn Bautista – bautista@law.stanford.edu
Rabia Belt – belt@law.stanford.edu
